C 135,206,235
F 161,64,43

NO ./textures/brick1.xpm
SO ./textures/brick2.xpm
WE ./textures/brick3.xpm
EA ./textures/brick4.xpm

        1111111111111111111111111
        1000000000110000000000001
        100000110000000000000N001
111101111111010111011110100011111

SO ./textures/brick2.xpm
