
C 135,206,235
F 161,64,43


NO ./textures/brick1.xpm
SO ./textures/brick2.xpm
WE ./textures/brick3.xpm
EA ./textures/brick4.xpm


        1111111111111111111111111
        1000000000110000000000001
        1011000001110000000000001
        1001000000000000000000001
111111111011000001110000000000001
100000000011000001110111111111111
11110111111111011100000010001
111101111111110111010100000011111
1100000011     101011100000010001
100000000000000011000000100011111
1000000000000001101010010001
11000001110101011111011110N0111
11110111 1110101 101111010001
11111111 1111111 111111111111
