NO ./textures/brick1.xpm
SO ./textures/brick2.xpm
WE ./textures/brick3.xpm
EA ./textures/brick4.xpm

C 58,50,45
F 190,200,195

  111111111111111111111
  100000000000001000001
  101001010100100010000111111
111101001000101111111100000011
10000010010000000000010111100011
11110100010010100111100000001001
  10N001101000001000001111111001
  101000000010000001011      101
  101011111111111111011111111101
11101000000000000000000000000001
11111111111111111111111111111111